¡á¡é¡á¡á¡á¡á¡á
¡á¡à¡á¡à¡á¡á¡à
¡á¡á¡á¡á¡á¡á¡á
¡á¡à¡á¡à¡á¡á¡à
¡á¡á¡á¡á¡á¡á¡á
¡á¡á¡á¡á¡á¡á¡á
¡á¡à¡á¡à¡á¡á¡à
